7 3 1 1 1 1 1 1 1 1 1 1 1 1 1 1 1 1 1
1 1 1 1 1 1 1 1 1 1 1 1 1 1 1 1 1 1 1
1 1 1 1 1 1 1 1 1 1 1 1 1 1 1 1 1 1 1
1 1 1 1 1 1 1 1 1 1 1 1 1 1 1 1 1 1 1
1 1 1 1 1 1 1 1 1 1 1 1 1 1 1 1 1 1 1
3 6 3 6 10 3 6 3 6 10 3 6 3 6 10 3 6 3 6
3 6 3 6 10 3 6 3 6 10 3 6 3 6 10 3 6 3 6 
3 6 3 6 10 3 6 3 6 10 3 6 3 6 10 3 6 3 6 
3 6 3 6 10 3 6 3 6 10 3 6 3 6 10 3 6 3 6 
3 6 3 6 10 3 6 3 6 10 3 6 3 6 10 3 6 3 6 
1 1 1 1 1 1 1 1 1 1 1 1 1 1 1 1 1 1 1 
1 1 1 1 1 1 1 1 1 1 1 1 1 1 1 1 1 1 1 
1 1 1 1 1 1 1 1 1 1 1 1 1 1 1 1 1 1 1 
1 1 1 1 1 1 1 1 1 1 1 1 1 1 1 1 1 1 1 
