7 3 4 1 1 1 1 1 1 1 1 1 1 1 1 1 1 1 1 1 
1 1 1 1 1 1 1 1 1 1 1 1 1 1 1 1 1 1 1 1 
1 1 1 1 1 1 1 1 1 1 9 1 1 1 1 1 1 1 1 1 
1 1 1 1 1 1 1 1 1 1 1 1 1 1 1 1 1 1 1 1 
1 1 1 1 1 1 1 1 1 1 1 1 1 1 1 1 1 1 1 1 
2 6 7 2 5 2 6 7 2 5 2 6 7 2 5 2 6 7 2 5 
2 6 7 2 5 2 6 7 2 5 2 6 7 2 5 2 6 7 2 5 
2 6 7 2 5 2 6 7 2 5 2 6 7 2 5 2 6 7 2 5 
2 6 7 2 5 2 6 7 2 5 2 6 7 2 5 2 6 7 2 5 
2 6 7 2 5 2 6 7 2 5 2 6 7 2 5 2 6 7 2 5 
7 3 4 1 1 1 1 1 1 1 1 1 1 1 1 1 1 1 1 1 
1 1 1 1 1 1 1 1 1 1 1 1 1 1 1 1 1 1 1 1 
1 1 1 1 1 1 1 1 1 1 1 1 1 1 1 1 1 1 1 1 
1 1 1 1 1 1 1 1 1 1 1 1 1 1 1 1 1 1 1 1 
1 1 1 1 1 1 1 1 1 1 1 1 1 1 1 1 1 1 1 1 