720 480
28 24 24 24 24 24 24 24 24 24 24 24 24 24 24
24 24 24 24 24 24 29 24 24 24 24 24 26 24 24
24 24 24 20 24 24 24 26 24 21 24 24 24 24 24
24 27 24 25 23 24 24 24 29 24 24 28 24 24 24
24 24 24 31 24 24 24 29 28 28 24 24 26 24 24
24 24 20 24 24 24 32 28 28 28 32 24 24 24 24
24 28 24 24 24 20 24 28 28 28 24 24 35 24 20
24 24 24 28 24 24 24 24 33 24 28 25 24 24 24
24 24 28 24 44 22 24 47 24 24 20 24 57 24 25
24 24 24 24 24 24 24 24 24 24 24 24 24 24 24
