720 480
20 24 24 24 24 24 24 24 24 24 24 24 24 24 24
24 24 24 24 24 24 24 24 24 24 24 24 24 24 24
24 24 24 30 24 24 24 24 28 24 28 24 24 24 24
23 24 24 24 24 24 24 24 28 28 24 24 24 24 24
26 27 22 28 24 24 24 24 23 24 24 24 29 24 24
32 27 24 24 24 28 24 24 24 28 24 24 24 24 24
38 24 29 24 25 29 24 24 29 24 24 24 24 24 30
24 28 24 24 24 24 24 24 24 24 24 24 24 24 24
24 24 24 28 24 24 29 24 24 24 30 24 24 24 24
24 29 24 24 24 24 24 24 24 24 24 24 24 24 24
