720 480
19 24 24 24 24 24 24 24 24 24 24 24 24 24 24
24 24 24 24 24 24 24 24 24 24 24 24 24 24 24
24 23 24 30 24 24 24 24 28 24 28 24 24 24 24
23 23 23 24 24 19 24 24 28 28 24 24 24 24 24
23 26 22 28 24 26 26 26 28 24 24 24 29 24 24
32 27 24 27 24 40 24 27 24 28 23 23 24 24 24
38 24 29 24 25 30 28 24 29 24 23 23 45 24 30
24 28 24 24 28 26 24 24 24 24 24 24 24 24 24
24 24 24 28 24 24 29 24 24 24 30 24 24 24 24
24 29 24 24 24 24 24 24 24 24 24 24 24 24 24
